#domain
hospital
#levelname
SAD1
#colors
red: 0,A
blue:1,B,C
#initial
+++++++++++++++++++
+0                +
+              ++++
+C                +
+              ++A+
+1            B + +
+++++++++++++++++++
#goal
+++++++++++++++++++
+                 +
+              ++++
+                 +
+     C        ++ +
+              B+A+
+++++++++++++++++++
#end
