#domain
hospital
#levelname
SAD1
#colors
red: 0,A
blue:1,B
#initial
+++++++++++++++++++
+A                +
+              ++++
+                 +
+            ++++ +
+1           B  +0+
+++++++++++++++++++
#goal
+++++++++++++++++++
+                 +
+              ++++
+                 +
+            ++++ +
+             B +A+
+++++++++++++++++++
#end
