#domain
hospital
#levelname
SAD1
#colors
red: 0,A,C
blue:1,B
#initial
+++++++++++++++++++
+0                +
+              ++++
+C                +
+              ++A+
+1            B + +
+++++++++++++++++++
#goal
+++++++++++++++++++
+                 +
+              ++++
+                B+
+              ++C+
+               +A+
+++++++++++++++++++
#end
