#domain
hospital
#levelname
SAD1
#colors
red: 0,A
blue:1,B, C
#initial
+++++++++++++++++++
+A                +
+              ++++
+                 +
+         C  ++++ +
+1           B  +0+
+++++++++++++++++++d
#goal
+++++++++++++++++++
+                 +
+              ++++
+    C            +
+            ++++ +
+             B +A+
+++++++++++++++++++
#end
