#domain
hospital
#levelname
SAD1
#colors
red: 0,1,B, A
#initial
+++++++++++++++++++
+0                +
+              ++++
+                 +
+              ++A+
+1            B + +
+++++++++++++++++++
#goal
+++++++++++++++++++
+                 +
+              ++++
+                 +
+              ++ +
+              B+A+
+++++++++++++++++++
#end
