#domain
hospital
#levelname
MAPullDistance
#colors
red: 0, 1, A
#initial
++++++++++++++++++++++++++++++++++++++++++++++++++
+                                               0+
+ ++++++++++++++++++++++++++++++++++++++++++++++ + 
+ +                                           A+ +
+ +                                            + +
+ +                                            + +
+ +                                            + +
+ +                                            + +
+ +                                            + +
+ +                                            + +
+ +                                            + +
+ +                                            + +
+ +                                            + +
+ +                                            + +
+ +                                            + +
+ +                                            + +
+ +                                            + +
+ +                                            + +
+ +                                            + +
+ +                                            + +
+ +                                            + +
+ +                                            + +
+ +                                            + +
+ +                                            + +
+ +                                            + +
+ +                                            + +
+ +                                            + +
+ +                                            + +
+ +                                            + +
+ +                                            + +
+ +                                            + +
+ +                                            + +
+ +                                            + +
+ +                                            + +
+ +                                            + +
+ +                                            + +
+ +                                            + +
+ +                                            + +
+ +                                            + +
+ +                                            + +
+ +                                            + +
+ +                                            + +
+ +                                            + +
+ +                                            + +
+ +                                            + +
+ +                                            + +
+ +                                            + +
+A+1                                             +
++++++++++++++++++++++++++++++++++++++++++++++++++
#goal
++++++++++++++++++++++++++++++++++++++++++++++++++
+                                                +
+ ++++++++++++++++++++++++++++++++++++++++++++++ + 
+ +                                            + +
+ +                                            + +
+ +                                            + +
+ +                                            + +
+ +                                            + +
+ +                                            + +
+ +                                            + +
+ +                                            + +
+ +                                            + +
+ +                                            + +
+ +                                            + +
+ +                                            + +
+ +                                            + +
+ +                                            + +
+ +                                            + +
+ +                                            + +
+ +                                            + +
+ +                                            + +
+ +                                            + +
+ +                                            + +
+ +                                            + +
+ +                                            + +
+ +                                            + +
+ +                                            + +
+ +                                            + +
+ +                                            + +
+ +                                            + +
+ +                                            + +
+ +                                            + +
+ +                                            + +
+ +                                            + +
+ +                                            + +
+ +                                            + +
+ +                                            + +
+ +                                            + +
+ +                                            + +
+ +                                            + +
+ +                                            + +
+ +                                            + +
+ +                                            + +
+ +                                            + +
+ +                                            + +
+ +                                            + +
+ +                                            + +
+ + A                                           A+
++++++++++++++++++++++++++++++++++++++++++++++++++
#end
