#domain
hospital
#levelname
SAD1
#colors
red: 0,A,D
green: 1,C,B
#initial
+++++++++++++
+ +         +
+ + +++++++++
+ + +0  AB  +
+ + +   CD  +
+ + +      1+
+ + +       +
+           +
++++++      +
++++++ ++++ +
++++++ ++++ +
++++++ ++++ +
+      ++++ +
+++++++++++++
#goal
+++++++++++++
+A+        C+
+ + +++++++++
+ + +       +
+ + +       +
+ + +       +
+ + +       +
+           +
++++++      +
++++++ ++++ +
++++++ ++++ +
++++++ ++++ +
+B     ++++D+
+++++++++++++
#end
