#domain
hospital
#levelname
SAD3
#colors
red: 0, A
#initial
+++++++++++++++++++
+ A               +
+           0  ++++
+    A            +
+              ++A+
+        A      +a+
+++++++++++++++++++
#goal
+++++++++++++++++++
+                 +
+           0  ++++
+                 +
+              ++ +
+               +A+
+++++++++++++++++++
#end
