#domain
hospital
#levelname
SAD4
#colors
red: 0, A ,B
#initial
+++++++++++++++++++
+B                +
+              ++++
+                 +
+              ++ +
+0            A + +
+++++++++++++++++++
#goal
+++++++++++++++++++
+                B+
+              ++++
+                 +
+              ++ +
+              A+ +
+++++++++++++++++++
#end
