#domain
hospital
#levelname
SAPullDistance
#colors
red: 0, A
#initial
++++++++++++++++++++++++++++++++++++++++++++++++++
+                                                +
+ ++++++++++++++++++++++++++++++++++++++++++++++ + 
+ +                                            + +
+ +                                            + +
+ ++                                           + +
+ A+                                           + +
+ ++                                           + +
+ +                                            + +
+ +                                            + +
+ +                                            + +
+ +                                            + +
+ +                                            + +
+ +                                            + +
+ +                                            + +
+ +                                            + +
+ +                                            + +
+ +                                            + +
+ +                                            + +
+ +                                            + +
+ +                                            + +
+ +                                            + +
+ +                                            + +
+ +                                            + +
+ +                                            + +
+ +                                            + +
+ +                                            + +
+ +                                            + +
+ +                                            + +
+ +                                            + +
+ +                                            + +
+ +                                            + +
+ +                                            + +
+ +                                            + +
+ +                                            + +
+ +                                            + +
+ +                                            + +
+ +                                            + +
+ +                                            + +
+ +                                            + +
+ +                                            + +
+ +                                            + +
+ +                                            + +
+ +                                            + +
+ +                                            + +
+ +                                            + +
+ +                                            + +
+0+A                                             +
++++++++++++++++++++++++++++++++++++++++++++++++++
#goal
++++++++++++++++++++++++++++++++++++++++++++++++++
+                                                +
+ ++++++++++++++++++++++++++++++++++++++++++++++ + 
+ +                                            + +
+ +                                            + +
+ ++                                           + +
+  +                                           + +
+ ++                                           + +
+ +                                            + +
+ +                                            + +
+ +                                            + +
+ +                                            + +
+ +                                            + +
+ +                                            + +
+ +                                            + +
+ +                                            + +
+ +                                            + +
+ +                                            + +
+ +                                            + +
+ +                                            + +
+ +                                            + +
+ +                                            + +
+ +                                            + +
+ +                                            + +
+ +                                            + +
+ +                                            + +
+ +                                            + +
+ +                                            + +
+ +                                            + +
+ +                                            + +
+ +                                            + +
+ +                                            + +
+ +                                            + +
+ +                                            + +
+ +                                            + +
+ +                                            + +
+ +                                            + +
+ +                                            + +
+ +                                            + +
+ +                                            + +
+ +                                            + +
+ +                                            + +
+ +                                            + +
+ +                                            + +
+ +                                            + +
+ +                                            + +
+ +                                            + +
+ + A                                           A+
++++++++++++++++++++++++++++++++++++++++++++++++++
#end
