#domain
hospital
#levelname
MAExample
#colors
red: 0, A, B, C, D, E, F, G, H, I, J, K, L, M, N
#initial
++++++++++++++++++++++++++
+       0                +
+         ABCDE          +
+              FG        +
+                        +
+ ++++++++++++++++++++++++
+ +
+ +
+ +
+ +
+ +
+ +
+++
#goal
++++++++++++++++++++++++++
+                        +
+                        +
+                        +
+                        +
+A++++++++++++++++++++++++
+B+
+C+
+D+
+E+
+F+
+G+
+++
#end
